50
30
66666666666666666666666666666666666666666666666666
66666666666666666666666666666666666666666666666666
66444444444444444444444444444444444444444444444466
66444444444444444444444444444444444444444444444466
664488P886666666688866656E88886O66666O656666664466
664488888O66E8888O66O665688888OO56666566666O664466
66446666864448888666OO566888885666688688666O664466
6644OO66668866888666666444444566666564456644444466
6644O66O88886666666666OO66O6O666O66666666M88884466
664466666666OOO6666666666868666666666OO6O888884466
664466666666666666666OOO88884444666666665666664466
66446M88888666OO666666666O6O444666666OO66666884466
664468888886OOO6666666666868666666666OO6O6O6O64466
6644688888886666668888OO8888OOOO666666665666664466
66446888888666OOE88888666O6OOOO666666OO66666884466
664444444444444444444448886666O6O6O66O666688884466
6644666666M8888866O6O66O6666666666OO66O64444444466
6644666666688888OO6666665886866666OO85O88866664466
664466444444446O6O644666666644885O6644444444664466
6644O66O844866666684444O68664466O66644566666O64466
664466666446666656644664OO5O44O6O66644666688584466
66448888844666O6OO6446664666445O566644666665664466
664468588448OOOOO684488584884466OO8644OO4444884466
66446O66O44666665684466566464485OO8844666644884466
66448688O44O68886664466888544466858644444444854466
66446666OOO566668866888O666844888686O6666666864466
66444444444444444444444444444444444444444444444466
66444444444444444444444444444444444444444444444466
66666666666666666666666666666666666666666666666666
66666666666666666666666666666666666666666666666666
