50
50
66666666666666666666666666666666666666666666666666
66666666666666666666666666666666666666666666666666
66444444444444444444444444444444444444444444444466
66444444444444444444444444444444444444444444444466
664488P886666M885888666666O6M88888866O656666664466
664488888O6666888888O66566O6888856666566666O664466
66446666864444666666OO566666885666688688666O664466
6644OO666688668886666664444445666665666665666O4466
6644O66O88886666666666OO66O6O666O66666666666O64466
664466666666OOO6666666666868666666666OOM8888864466
664466666688666666666OOO88884444666666685888864466
6644M888886666OO666666666O6O444666666OO86888884466
664488888856666666666666OOOO44O6O6O66O666688884466
6644888888OOO66666O6O66O666O466666OO6O6666888O4466
6644886666666O6OOO6666665886866666OO85O88866664466
664466666666OO6O6O888888O56666666OOOO6666O6O664466
6644O66O888866666688M88866666666666566M88888864466
664466666656666665666888666666O666O688668888884466
664488888O6666O6OO666665666666O6665665666688884466
66446658868OOOOOO6668885886666666O688OOO8866664466
66446O66O86O66O6566665O666666656OO8886666666884466
66448688OOOO88686666666888M88666658OOO8M8888O54466
66446666O6656666888888O88888888886OOO6668866664466
6644888M88865OO6666O66666666OOO45O66O6666O888O4466
66446888OOO66668888656O688866666OOOO566886OOO64466
66448OOOO6O6666OOOO666666666OO666666O68888OO564466
6644O6666O688O5O666666O6666466688866665OOO66664466
66446666666666666666666666666444448888666568884466
6644888888888888888888888888888888666566666O664466
664466688M88888888888888888888M888688688666O664466
66448888888888888888M888888OO5888888888888655O4466
6644O66O88886666666666OO66O6O666O66666666666O64466
664466666666OOO6666666666868666666666OO6O6O6O64466
664466666688666666666OOO8888OOOO666666665666664466
66446666666666OO666666666O6OOOO666666OO66666884466
664466666666666666666668886666O6O6O66O666688884466
66446644444444466644444444664444446666444444664466
6644664466666O6OOO4466664486446664O585O88844684466
664466446666OO6O6O4468884466446664OOO5666O44664466
6644O644888866666644444444O64444446566444444O64466
66446644665666666644666644OO44O6O6O56O668844584466
664488448O644446OO446885446644OO566665666644664466
66448844868OO44OO644888544884466OO68858O8844664466
66446O44444444465644666644564485OO8886444444884466
66448688OOOO88686666666888586666658OOO8886OOO54466
66446666OOO566668888866O6666688886OOO6668866664466
66444444444444444444444444444444444444444444444466
66444444444444444444444444444444444444444444444466
66666666666666666666666666666666666666666666666666
66666666666666666666666666666666666666666666666666
