30
30
BBBBBBBBBBBBBBBBBBBBBBBBBBBBBB
BBBBBBBBBBBBBBBBBBBBBBBBBBBBBB
BBUUUUUUUUUUUUUUUUUUUUUUUUUUBB
BBUUUUUUUUUUUUUUUUUUUUUUUUUUBB
BBUUbbbbbBBBBBBBDbbbBBBEbbUUBB
BBUUbbbbbRBBBBRBRRBBRBBDbbUUBB
BBUUBBBBbBUUUUBBBBBBRRDBBBUUBB
BBUURRBBBBbbBBbBEbbbBBBUUUUUBB
BBUURBBRbbbbBBBBbbbbbBRRBBUUBB
BBUUBBBBBBBBRRRBBBBBBBBBBbUUBB
BBUUBBBBBBbbBBBBBBBUUUUUUUUUBB
BBUUBBBUUUUUUBRRBBBBBEbbbRUUBB
BBUUBBBBUUDBBBBBBBBBBbbbbRUUBB
BBUUBBBBBBRRRBBBBBRBRbbbbBUUBB
BBUUBBBBBBBBBBRRBBBBBBBBBRUUBB
BBUUBBBBBBBBBBBBBBBBBBBbbbUUBB
BBUUbbbbBBRRRBBBBBRBRBBRBBUUBB
BBUUEbbbBBBBBRBRRRBBRRRBDbUUBB
BBUUUUUUUUUBRRBRBUUBBBBBBBUUBB
BBUURBBRBUUbBBBBbUUbbbbbbbUUBB
BBUUBBBBBUUBDBBDBUUEbbbbbbUUBB
BBUUUUUUUUUbDbRbbUUUUUUUUUUUBB
BBUUBBDbbBbUUUUURUUBbbbDbbUUBB
BBUUBRBBRbBRBBRBDUUDBBBBBBUUBB
BBUUbBbbRRRRbbBbBUUBBBBbbbUUBB
BBUUBBBBRRRDbbBBbUUbbBBRBBUUBB
BBUUUUUUUUUUUUUUUUUUUUUUUUUUBB
BBUUUUUUUUUUUUUUUUUUUUUUUUUUBB
BBBBBBBBBBBBBBBBBBBBBBBBBBBBBB
BBBBBBBBBBBBBBBBBBBBBBBBBBBBBB