50
30
BBBBBBBBBBBBBBBBBBBBBBBBBBBBBBBBBBBBBBBBBBBBBBBBBB
BBBBBBBBBBBBBBBBBBBBBBBBBBBBBBBBBBBBBBBBBBBBBBBBBB
BBUUUUUUUUUUUUUUUUUUUUUUUUUUUUUUUUUUUUUUUUUUUUUUBB
BBUUUUUUUUUUUUUUUUUUUUUUUUUUUUUUUUUUUUUUUUUUUUUUBB
BBUUbbPbbBBBBBBBDbbbBBBBBBRBBRBRBBBBBRBDBBBBBBUUBB
BBUUbbbbbRBBBBRBRRBBRBBDBBRBBBRRDBBBBDBBBBBRBBUUBB
BBUUBBBBbBUUUUBBBBBBRRDBBBBBBBDBBBBbbBbbBBBRBBUUBB
BBUURRBBBBbbBBbbbBBBBBBUUUUUUDBBBBBDBUUUBDUUUUUUBB
BBUURBBRbbbbBBBBBBBBBBRRBBRBRBBBRBBBBBBBBBBBRBUUBB
BBUUBBBBBBBBRRRBBBBBBBBBBbBbBBBBBBBBBRRBRBRBRBUUBB
BBUUBBBBBBbbBBBBBBBBBRRRbbbbUUUUBBBBBBBBDBBBBBUUBB
BBUUBBBBBBBBBBRRBBBBBBBBBRBRUUUBBBBBBRRBBBBBbbUUBB
BBUUBBBBBBBBRRRBBBBBBBBBBbBbBBBBBBBBBRRBRBRBRBUUBB
BBUUBBBBBBbbBBBBBBBBBRRRbbbbRRRRBBBBBBBBDBBBBBUUBB
BBUUBBBBBBBBBBRRBBBBBBBBBRBRRRRBBBBBBRRBBBBBbbUUBB
BBUUUUUUUUUUUUUUUUUUUUUbbbBBBBRBRBRBBRBBBBbbbbUUBB
BBUUBBBBBBRRRBBBBBRBRBBRBBBBBBBBBBRRBBRBUUUUUUUUBB
BBUUBBBBBBBBBRBRRRBBBBBBDbbBbBBBBBRRbDRbbbBBBBUUBB
BBUUUUUUUUUUUUBRBRUUUUUUUUUBBbbbDRUUUUUUUUBRBBUUBB
BBUURBBRbbbbBBBBBBUUBBBRBBUBRBBBRBUUBBDBUUBBRBUUBB
BBUUBBBBBBDBBBBBDBUUBBBBRRURRBRBRBUUBRBBUUbbDbUUBB
BBUUbbbbbRBBBBRBRRUUUUUUUUUBBBDRDBUUUUUUUUBDBBUUBB
BBUUBBDbbBbRRRRRRBUUbBBDbbbbBBBBRRUUbbRRUUbRbbUUBB
BBUUBRBBRbUUUUUBDBUUBBBDBBDBBbbBRRUUbBBBUUBBbbUUBB
BBUUbBbbRBBRBUUbBBUUBBBbbbDbBBBBbDUURRbbUURRbDUUBB
BBUUBBBBRRRDBUUBbbUUbbbRBBBbBbbbbBUURBBBUUBBbBUUBB
BBUUUUUUUUUUUUUUUUUUUUUUUUUUUUUUUUUUUUUUUUUUUUUUBB
BBUUUUUUUUUUUUUUUUUUUUUUUUUUUUUUUUUUUUUUUUUUUUUUBB
BBBBBBBBBBBBBBBBBBBBBBBBBBBBBBBBBBBBBBBBBBBBBBBBBB
BBBBBBBBBBBBBBBBBBBBBBBBBBBBBBBBBBBBBBBBBBBBBBBBBB